XXXXXXXXXXXXXXXXXXXX
XSX       XXX      X
XPX XXX X XXX XXXX X
X   XXX X XXX XXXX X
XX XXXX X   X XXXX X
X   XXX XXXXX XXXX X
X X XXX XXXXX XXXX X
X X XXX XXXXX XXXX X
XXXXXXX XXXXX   XX X
XXX     XXXXX XXXX X
XXXXXXX   XXX XXXX X
XX      XXXXX XX   X
XX XXXX    XX XX X X
XX X    XXXXX XXXX X
XX X XX XX XX X    X
X  X XX XX XX X XX X
XXXXXXX XX XX X XX X
XX      XX XX XXXX X
XXXXXXX       XXXXKX
XXXXXXXXXXXXXXXXXXXX